20
15
22 22 22 22 22 22 22 22 22 22 22 22 22 22 22 22 22 22 22 22 
22 0 0 0 0 0 0 0 0 0 0 0 0 0 22 8 0 0 0 22 
22 0 0 0 0 0 0 0 0 0 1 21 21 21 28 21 21 2 0 22 
22 0 0 1 21 2 0 0 0 1 24 2 22 0 0 0 22 0 0 22 
26 21 21 21 21 8 23 24 24 25 2 0 21 21 21 8 21 2 0 22 
22 22 22 22 22 0 0 0 0 0 0 0 0 0 0 0 22 0 0 22 
22 0 0 0 22 0 1 21 2 1 21 21 21 8 21 2 22 0 0 22 
22 0 0 0 22 0 0 22 1 21 27 22 22 0 22 0 22 0 0 22 
26 21 2 0 0 0 1 21 21 21 27 22 22 0 22 0 22 0 0 22 
22 22 0 0 0 1 21 27 0 0 0 0 0 0 22 0 22 0 0 22 
22 26 23 25 2 0 0 0 0 0 0 0 0 0 22 0 22 0 0 22 
22 22 0 0 0 0 0 0 0 0 0 0 0 0 22 0 0 0 0 22 
22 0 0 0 1 21 2 0 0 0 0 0 0 0 22 0 0 0 0 22 
26 21 21 21 21 21 21 2 1 21 21 21 21 8 21 21 21 21 21 27 
0 0 0 0 0 0 0 0 0 0 0 0 0 0 0 0 0 0 0 0 
