60
30
22 22 22 0 0 0 0 0 0 0 0 0 0 0 0 0 0 0 0 0 0 1 21 21 2 0 0 0 0 0 0 0 0 0 0 0 0 0 0 0 0 22 22 22 22 22 22 22 22 22 22 22 22 22 22 22 22 22 22 22 
22 22 22 0 1 21 21 21 21 21 21 21 21 21 21 21 21 21 21 21 21 21 27 22 0 0 0 0 0 0 0 0 0 0 0 0 0 0 0 22 0 22 0 0 0 0 0 0 0 0 0 0 0 0 0 0 0 22 0 22 
22 22 22 0 0 0 0 0 0 0 0 0 0 0 0 0 0 0 0 0 0 0 22 22 0 0 0 0 0 0 0 0 0 0 0 0 0 0 22 0 0 22 0 22 22 22 0 0 22 0 0 0 0 22 22 22 0 0 0 22 
22 22 22 0 0 0 0 0 0 0 0 0 0 0 0 0 0 0 0 0 0 0 22 26 21 2 0 0 0 0 0 0 0 0 0 0 0 0 0 0 0 22 0 22 22 0 0 22 22 0 0 0 22 0 0 0 0 22 0 22 
22 22 26 21 21 21 21 21 21 21 21 21 21 21 21 21 21 21 21 21 2 0 22 22 22 0 0 0 0 0 0 0 0 0 0 0 0 0 22 0 0 22 0 22 0 0 22 0 0 22 22 22 0 0 22 22 0 0 0 22 
22 22 22 0 0 0 0 0 0 0 0 0 0 0 0 0 0 0 0 0 0 0 22 22 22 0 0 0 0 0 0 0 0 0 0 0 0 0 0 22 0 22 0 22 0 0 0 0 0 0 0 22 0 22 0 22 22 0 0 22 
22 22 22 0 0 0 0 0 0 0 0 0 0 0 0 0 0 0 0 0 0 0 22 22 26 21 2 0 0 0 0 0 0 0 0 0 0 0 0 0 0 22 0 22 0 22 0 22 22 22 0 22 0 0 0 0 22 22 0 22 
22 22 22 0 1 21 21 21 21 21 21 21 21 21 21 21 21 21 21 21 21 21 27 22 22 22 0 0 0 0 0 0 0 0 0 0 0 22 0 22 0 22 0 22 22 0 0 0 22 0 0 0 22 22 22 0 22 0 0 22 
22 22 22 0 0 0 0 0 0 0 0 0 0 0 0 0 0 0 0 0 0 0 22 22 22 22 0 0 0 0 0 0 0 0 0 0 0 0 0 22 0 22 0 22 0 0 22 0 0 0 0 0 0 0 0 0 0 0 0 22 
22 22 22 0 0 0 0 0 0 0 0 0 0 0 0 0 0 0 0 0 0 0 22 22 22 26 21 2 0 0 0 0 0 0 0 0 0 22 0 22 0 22 0 0 0 22 0 22 22 0 0 0 0 22 0 22 0 22 0 22 
22 22 22 0 0 0 0 0 0 0 0 0 0 0 0 0 0 0 0 0 0 0 22 22 22 22 22 0 0 0 0 0 0 0 0 0 0 0 0 0 0 22 0 22 0 22 0 0 0 0 0 0 0 22 0 0 0 0 0 22 
22 22 22 0 0 0 0 0 0 0 0 0 0 0 0 0 0 0 0 0 0 0 22 22 22 22 22 0 0 0 0 0 0 0 0 0 0 0 22 22 0 22 22 22 22 22 22 22 22 22 0 0 22 22 22 22 22 22 22 22 
22 22 22 0 0 0 0 0 0 0 0 0 0 0 0 0 0 0 0 0 0 0 22 22 22 22 26 21 2 0 0 0 0 0 0 0 0 0 0 0 0 0 0 0 0 0 0 0 0 22 0 0 22 0 0 0 0 0 0 0 
22 22 22 0 0 0 0 0 0 0 0 0 0 0 0 0 0 0 0 0 0 0 22 22 22 22 22 22 0 0 0 0 0 0 0 0 0 0 0 22 0 22 0 22 0 0 22 22 0 22 0 0 22 0 0 0 22 0 22 0 
22 22 22 0 0 0 0 0 0 0 0 0 0 0 0 0 0 0 0 0 0 0 22 22 22 22 22 22 0 0 0 0 0 0 0 0 0 0 0 0 0 22 0 0 0 22 0 0 0 22 0 0 22 0 22 22 0 0 0 0 
22 22 22 0 0 0 0 0 0 0 0 0 0 0 0 0 0 0 0 0 0 0 22 22 22 22 22 26 21 2 0 0 0 0 0 0 0 0 0 0 22 0 0 0 22 0 22 0 0 22 0 0 22 0 22 0 0 0 0 22 
22 22 22 0 0 0 0 0 0 0 0 0 0 0 0 0 0 0 0 0 0 0 22 22 22 22 22 22 22 0 0 0 0 0 0 0 0 0 0 0 0 0 0 0 0 0 0 0 0 22 0 0 22 0 22 0 22 0 0 0 
22 22 22 0 0 0 0 0 0 0 0 0 0 0 0 0 0 0 0 0 0 0 22 22 22 22 22 22 22 0 0 0 0 0 0 0 0 0 0 0 0 0 22 0 0 22 0 22 0 0 0 0 0 0 0 0 0 22 0 0 
22 22 22 0 0 0 0 0 0 0 0 0 0 0 0 0 0 0 0 0 0 0 22 22 22 22 22 22 26 21 2 0 0 0 0 0 0 0 0 0 0 0 0 0 0 0 22 0 0 0 0 0 0 0 22 0 0 0 0 0 
22 22 22 0 0 0 0 0 0 0 0 0 0 0 0 0 0 0 0 0 0 0 22 22 22 22 22 22 22 22 0 0 0 0 0 0 0 0 0 0 0 0 0 0 0 0 0 0 0 0 0 0 0 22 22 0 22 0 0 0 
22 22 22 0 0 0 0 0 0 0 0 0 0 0 0 0 0 0 0 0 0 0 22 22 22 22 22 22 22 22 0 0 0 0 0 0 0 0 0 0 0 0 0 22 22 0 0 0 22 0 0 0 0 0 0 0 0 0 0 22 
22 22 22 0 0 0 0 0 0 0 0 0 0 0 0 0 0 0 0 0 0 0 22 22 22 22 22 22 22 26 21 2 0 0 0 0 0 0 0 0 0 0 0 0 0 0 22 0 0 0 0 0 0 0 0 22 0 0 22 0 
22 22 22 0 0 0 0 0 0 0 0 0 0 0 0 0 0 0 0 0 0 0 22 22 22 22 22 22 22 22 22 0 0 0 0 0 0 0 0 0 0 0 0 0 0 0 0 0 0 0 0 0 0 0 0 0 0 0 0 0 
22 22 22 0 0 0 0 0 0 0 0 0 0 0 0 0 0 0 0 0 0 0 22 22 22 22 22 22 22 22 22 0 0 0 0 0 0 0 0 0 0 0 0 0 0 0 0 0 0 0 0 0 0 0 0 0 0 0 0 0 
22 22 22 0 0 0 0 0 0 0 0 0 0 0 0 0 0 0 0 0 0 0 22 22 22 22 22 22 22 22 26 21 2 0 0 0 0 0 0 0 0 0 0 0 0 0 0 0 0 0 0 0 0 0 0 0 0 0 0 0 
22 22 22 25 2 0 0 0 0 0 0 0 0 0 0 0 0 0 0 0 1 23 22 22 22 22 22 22 22 22 22 22 0 0 0 0 0 0 0 0 0 0 0 0 0 0 0 0 0 0 0 0 0 0 0 0 0 0 0 0 
22 22 22 0 0 0 0 0 0 0 0 0 0 0 0 0 0 0 0 0 0 0 22 22 22 22 22 22 22 22 22 22 0 0 0 0 0 0 0 0 0 0 0 0 0 0 0 0 0 0 0 0 0 0 0 0 0 0 0 0 
22 22 22 0 0 0 0 0 0 0 0 0 0 0 0 0 0 0 0 0 0 0 22 22 22 22 22 22 22 22 22 26 21 2 0 0 0 0 0 0 0 0 0 0 0 0 0 0 0 0 0 0 0 0 0 0 0 0 0 0 
22 22 22 1 21 21 21 21 21 21 21 21 21 21 21 21 21 21 21 21 21 2 22 22 22 22 22 22 22 22 22 22 22 0 1 23 24 24 25 2 0 0 0 0 0 0 0 0 0 0 0 0 0 0 0 0 0 0 0 0 
22 22 26 21 27 22 22 22 22 22 22 22 22 22 22 22 22 22 22 22 26 21 27 22 22 22 22 22 22 22 22 22 22 0 0 0 0 0 0 0 0 1 21 21 21 21 21 21 21 21 21 21 21 21 21 21 21 21 21 21 
