60
30
22 22 22 22 22 22 22 22 22 22 22 22 22 22 22 22 22 22 22 22 22 22 22 22 22 22 22 22 22 22 22 22 22 22 22 22 22 22 22 22 22 22 22 22 22 22 22 22 22 22 22 22 22 22 22 22 22 22 22 22 
22 0 0 0 0 0 0 0 0 0 0 0 0 0 0 0 0 0 0 0 0 22 0 0 0 0 0 22 22 0 0 0 0 0 0 0 0 0 0 0 0 0 0 0 0 0 0 0 0 0 0 0 0 0 0 0 0 0 0 22 
22 0 0 0 0 0 0 0 0 0 0 0 0 0 0 0 0 0 0 0 0 22 0 0 0 0 0 0 0 0 0 1 24 8 24 8 21 21 21 21 21 21 21 21 21 21 21 21 21 21 21 21 21 21 21 21 21 21 2 22 
22 0 0 0 0 0 0 0 0 0 0 0 0 0 0 0 0 0 0 0 0 0 0 1 21 21 21 21 21 21 21 21 21 21 21 21 2 0 0 0 0 22 0 0 0 0 0 0 0 0 0 0 0 0 0 0 0 22 0 22 
22 0 1 23 24 25 2 0 0 0 0 0 0 0 0 0 0 0 0 0 0 0 0 0 22 0 0 0 0 0 0 0 0 0 0 1 21 8 21 2 0 22 0 1 21 21 21 21 21 21 21 21 21 21 21 2 0 22 0 22 
22 0 0 22 0 0 0 0 0 0 0 0 0 0 0 0 0 0 0 0 0 0 0 0 22 0 0 0 0 0 0 0 0 0 0 0 22 0 22 0 0 22 0 0 22 0 0 0 1 21 2 0 0 0 0 0 0 0 0 0 
22 0 0 22 0 0 0 0 0 0 1 23 24 25 2 0 0 1 23 25 2 1 21 21 28 21 21 21 21 8 21 21 21 21 2 0 22 0 22 0 0 22 0 0 22 0 0 0 0 0 0 0 0 0 0 0 0 0 0 0 
22 0 0 22 0 0 0 0 0 0 0 0 0 0 0 0 0 0 0 0 0 0 22 0 0 22 0 0 0 0 0 0 0 22 0 0 22 0 22 0 0 22 0 0 22 0 0 0 1 21 2 0 0 1 24 2 0 0 0 0 
22 0 0 0 0 0 0 0 0 0 0 0 0 0 0 0 0 0 0 0 0 0 22 0 0 22 0 0 0 0 0 0 0 22 0 0 22 0 22 0 0 0 0 0 22 0 0 0 0 22 0 0 1 23 25 2 0 0 0 0 
22 0 0 0 0 0 0 0 0 0 0 0 0 0 0 0 0 0 0 0 0 0 22 0 0 22 0 0 0 0 0 0 0 22 0 0 22 0 22 0 1 21 2 0 22 0 0 0 0 22 0 0 0 0 0 0 0 0 0 0 
22 0 0 0 0 0 0 0 0 0 0 0 0 0 0 0 0 0 0 0 0 0 22 0 0 26 21 21 21 21 21 21 21 27 0 0 22 0 22 0 0 22 0 0 26 21 2 0 0 22 0 0 0 0 0 0 0 0 0 0 
22 0 0 0 0 0 0 0 0 0 0 0 0 0 0 0 0 0 0 0 0 0 22 0 0 22 0 0 0 0 0 0 0 22 0 0 22 0 22 0 0 22 0 0 22 22 0 0 0 22 0 0 0 0 0 0 0 0 0 0 
26 24 2 0 0 0 0 0 0 0 0 0 0 0 0 0 0 0 0 0 0 0 22 0 0 22 0 0 0 0 0 0 0 22 0 0 22 0 22 0 0 22 0 0 22 26 21 2 0 22 0 0 0 0 0 0 0 0 0 0 
22 0 0 0 1 24 2 0 0 0 0 0 1 24 2 0 0 1 24 2 0 0 22 0 0 22 0 1 23 24 25 2 0 22 0 0 22 0 22 0 0 22 0 0 0 22 22 0 0 0 0 0 0 0 0 0 0 0 0 0 
22 0 0 0 0 0 0 0 0 0 0 0 0 0 0 1 24 2 0 0 0 0 22 0 0 22 0 0 0 22 0 0 0 22 0 0 22 0 22 0 0 22 0 0 0 22 26 21 21 21 21 21 21 21 21 21 21 2 0 0 
22 0 0 0 0 0 0 0 0 0 0 0 0 0 0 0 0 0 0 0 0 0 22 0 0 22 0 0 0 22 0 0 0 22 0 0 22 0 26 21 21 27 0 0 0 0 22 0 0 0 0 0 0 0 0 0 0 0 0 0 
22 0 0 0 1 24 2 0 0 1 24 2 0 0 0 0 0 0 0 0 0 0 22 0 0 22 0 0 1 21 2 0 0 22 0 0 22 0 0 0 0 22 0 0 0 0 22 22 22 22 22 22 0 1 21 2 0 0 0 0 
22 0 0 0 0 0 0 1 24 2 0 0 0 0 0 0 0 0 0 0 1 21 2 0 0 22 0 0 0 22 0 0 0 22 0 0 1 21 2 0 0 22 0 0 0 0 0 22 22 22 22 22 0 0 22 0 0 0 0 0 
22 0 0 0 0 0 0 0 0 0 0 0 0 0 0 0 0 0 0 1 21 2 0 0 0 22 0 0 0 22 0 0 0 22 0 0 0 1 21 2 0 22 0 0 0 0 0 22 22 22 22 0 0 0 22 0 0 0 0 0 
22 0 0 0 0 0 0 0 0 0 0 0 0 0 0 0 0 0 1 21 2 0 0 1 21 21 2 0 1 21 2 0 1 21 21 2 0 0 1 21 2 22 0 0 0 0 0 0 22 22 22 0 1 21 2 1 21 21 21 27 
22 0 0 0 0 0 0 0 0 0 0 0 0 0 0 0 0 0 0 0 0 0 1 21 2 0 0 0 0 22 0 0 0 0 1 21 2 0 0 0 0 22 0 0 0 0 0 0 22 22 22 0 0 22 0 0 0 0 0 22 
22 0 0 0 0 0 0 0 0 0 0 0 0 0 0 0 0 0 0 0 0 1 21 2 0 0 0 0 0 22 0 0 0 0 0 1 21 2 1 24 2 22 0 0 0 0 0 0 0 22 22 0 0 26 21 21 21 2 0 22 
22 0 0 0 0 0 0 0 0 0 0 0 0 0 0 0 1 21 21 21 21 21 2 0 0 0 0 0 1 21 2 0 0 0 0 0 1 21 21 21 21 27 0 0 0 0 0 0 0 22 22 0 0 0 22 0 0 0 0 22 
22 0 1 24 2 0 0 0 0 1 23 24 24 24 24 25 2 22 0 0 0 0 0 0 0 1 23 24 24 24 24 24 25 2 0 0 0 0 0 0 0 0 0 0 0 0 0 0 0 0 22 0 0 0 22 0 0 0 0 22 
22 0 0 0 0 0 0 0 0 0 0 0 0 0 0 0 0 0 0 22 0 0 0 0 1 23 25 2 0 0 0 1 23 25 2 0 0 0 0 0 0 0 0 0 0 0 0 0 0 0 26 21 2 0 22 0 1 21 21 27 
22 0 1 24 2 0 0 0 0 0 0 0 0 0 0 0 0 0 0 22 0 0 0 1 23 25 27 0 0 0 0 0 26 23 25 8 21 2 0 0 0 0 0 0 0 0 0 0 0 0 0 0 0 0 1 21 2 0 0 22 
22 0 0 0 0 0 0 0 0 0 0 0 0 0 0 0 0 0 0 22 0 0 1 23 25 2 22 0 1 21 2 0 22 1 23 25 28 21 21 21 21 21 2 0 0 0 0 0 0 0 0 0 0 0 0 22 1 21 2 22 
22 0 1 24 2 0 0 0 0 0 1 21 2 0 0 0 0 0 0 22 0 0 0 0 0 0 22 0 0 22 0 0 22 0 0 0 0 0 0 0 0 1 21 21 21 21 21 21 8 21 21 21 21 2 0 26 21 27 0 22 
22 0 0 0 0 0 0 0 0 0 0 22 0 0 0 0 0 0 0 0 0 0 0 0 0 0 0 0 0 22 0 0 0 0 0 0 0 0 0 0 0 0 0 0 0 0 0 0 0 0 0 0 0 0 0 0 0 0 0 22 
22 1 21 21 21 21 21 2 1 21 2 22 1 21 21 21 21 21 21 21 21 2 1 21 21 21 21 21 21 28 21 21 21 21 21 21 21 21 2 1 21 21 21 21 21 21 21 8 21 8 21 21 21 21 21 21 21 21 21 27 
