60
30
22 22 22 22 22 22 22 22 22 22 22 22 22 22 22 22 22 22 22 22 22 22 22 22 22 22 22 22 22 22 22 22 22 22 22 0 22 22 22 22 22 22 0 22 22 22 22 22 22 22 22 22 22 22 22 22 0 22 22 22 
0 0 0 0 0 0 0 0 0 1 21 2 0 0 0 0 0 0 0 0 0 0 0 0 0 0 0 0 0 0 0 0 0 22 22 0 22 22 22 22 22 22 0 22 22 22 22 22 0 0 0 0 0 0 0 22 0 0 0 22 
1 21 21 2 0 0 0 1 21 2 22 0 1 21 21 21 21 21 21 21 21 21 21 8 21 8 21 8 21 8 21 8 21 27 22 0 22 22 22 22 22 22 0 22 22 22 22 22 25 2 0 1 23 21 2 22 0 0 0 0 
0 22 22 0 0 0 0 0 0 1 21 2 0 22 0 0 0 0 0 0 0 0 1 21 2 0 1 21 8 21 2 0 0 22 22 0 22 22 22 22 22 22 0 22 22 22 22 22 0 0 0 0 0 22 0 22 0 0 1 21 
0 22 22 0 0 0 0 0 0 0 22 0 1 21 2 0 0 0 0 0 1 21 2 1 21 8 21 2 0 0 1 21 2 22 22 0 22 22 22 22 22 22 0 22 22 22 22 22 0 0 0 0 0 22 0 26 21 21 21 27 
0 22 22 0 0 0 0 0 0 1 21 2 0 22 25 2 0 0 0 0 0 1 21 2 1 21 2 1 21 8 21 2 0 22 22 0 22 22 22 22 22 22 0 22 22 22 22 22 0 0 0 0 0 22 0 22 0 0 0 0 
21 27 0 0 0 0 0 0 0 0 22 0 1 21 2 0 0 0 0 0 0 0 1 21 2 1 21 2 1 21 2 1 21 27 22 0 22 22 22 22 22 22 0 22 22 22 22 22 0 0 0 0 0 22 0 22 0 0 0 0 
22 22 0 0 0 0 0 1 21 8 21 2 0 22 0 0 0 0 0 0 0 0 0 1 21 2 1 21 2 1 21 2 0 22 26 21 27 22 22 22 22 22 0 22 22 22 22 26 21 21 21 21 21 27 0 22 0 0 1 21 
22 22 0 0 0 0 0 0 0 0 22 0 1 21 2 0 0 0 0 0 0 0 1 21 2 1 21 8 21 2 1 21 2 0 0 0 22 0 0 0 0 0 0 0 0 0 0 0 0 0 0 0 0 0 0 22 0 0 0 22 
22 22 0 0 0 0 0 0 0 1 21 2 0 22 0 0 0 0 0 0 0 1 21 27 1 21 2 0 1 21 2 1 21 21 21 2 22 0 0 0 0 0 0 0 0 0 0 0 1 8 8 2 0 0 0 22 0 0 0 22 
22 22 0 0 0 0 0 0 0 0 22 0 1 21 2 0 0 0 0 0 1 21 2 22 0 0 1 21 2 1 21 2 0 0 0 0 22 0 0 0 0 0 0 0 0 0 0 1 2 0 0 1 2 0 0 22 0 0 0 0 
22 22 0 0 0 0 0 0 0 1 21 2 0 22 0 0 0 0 0 1 21 2 0 22 1 21 21 28 21 2 0 1 21 21 21 21 27 0 0 0 0 0 0 0 0 0 0 0 0 0 0 0 1 2 0 22 0 0 0 0 
22 22 0 0 0 0 0 0 0 0 22 0 1 21 2 0 0 0 1 21 2 0 0 26 21 2 0 0 22 0 0 0 0 0 0 0 0 0 0 0 0 0 0 0 0 0 0 0 0 0 0 0 1 2 0 22 0 0 0 0 
22 26 21 2 0 0 0 0 0 1 21 2 0 22 1 21 21 21 21 2 0 0 0 0 0 0 0 0 0 0 0 0 0 0 0 0 0 0 0 0 0 0 0 0 0 0 0 0 0 0 0 0 1 2 0 22 0 0 1 21 
22 22 0 0 0 0 0 1 21 21 27 0 1 21 2 0 0 0 0 1 21 21 21 21 2 0 0 0 0 0 0 0 0 0 0 0 0 0 0 0 0 0 0 0 0 0 0 0 0 0 1 8 2 0 0 22 0 0 0 22 
22 22 0 0 0 0 0 0 0 1 21 2 0 22 0 0 1 21 8 21 2 0 0 0 0 1 21 2 0 0 0 0 0 0 0 0 0 0 0 0 0 0 0 0 0 0 0 0 0 0 0 0 1 2 0 22 0 0 0 22 
22 22 0 0 0 0 0 0 0 0 22 0 1 21 2 0 0 1 21 2 0 0 1 21 2 0 0 0 0 0 0 0 0 0 0 0 0 0 0 0 0 0 0 0 0 0 0 0 0 0 0 0 1 2 0 22 0 0 0 22 
22 22 0 0 0 0 0 0 0 1 21 2 0 22 0 0 0 0 22 0 0 0 0 22 0 0 0 0 0 0 0 0 0 0 0 0 0 0 0 0 0 0 0 0 0 0 0 0 0 0 0 0 1 2 0 22 0 0 0 0 
22 22 0 0 0 0 0 0 0 0 22 0 1 21 2 0 0 0 22 0 0 0 0 22 0 0 0 0 0 0 0 0 0 0 0 0 0 0 0 0 0 0 0 0 0 0 0 1 2 0 0 1 2 0 0 22 0 0 0 0 
22 22 0 0 0 0 0 0 0 0 0 0 0 22 0 0 0 0 0 0 0 0 0 22 0 0 0 0 0 0 0 0 0 0 0 0 0 0 0 0 0 0 0 0 0 0 0 0 1 8 8 2 0 0 0 22 0 0 1 21 
22 26 21 2 0 0 0 0 0 1 21 21 21 2 0 0 0 0 0 0 1 21 21 27 0 0 0 0 0 0 1 24 2 0 0 0 0 0 1 23 25 2 0 0 0 0 0 0 0 0 0 0 0 0 0 22 0 0 0 22 
22 22 0 0 0 0 0 0 0 0 0 0 0 0 0 0 0 0 0 0 0 0 0 0 0 0 0 0 0 0 0 0 0 0 0 0 0 0 0 0 0 0 0 0 0 0 1 23 24 25 2 0 0 0 0 22 0 0 0 22 
22 22 0 0 0 0 0 0 0 0 0 0 0 0 0 0 0 0 0 0 0 0 0 0 0 0 0 0 0 0 0 0 0 0 0 0 0 0 0 0 0 0 0 0 0 0 0 0 0 0 0 0 0 0 0 22 0 0 0 22 
22 22 0 0 0 0 0 0 0 0 0 0 0 0 0 0 0 0 0 0 0 0 0 0 0 0 0 0 0 0 0 0 0 0 0 0 0 0 0 0 0 0 0 0 0 0 0 0 0 0 0 0 0 1 23 22 0 0 0 0 
22 22 0 0 0 0 0 0 0 0 0 0 0 0 0 0 0 0 0 0 0 0 0 0 0 0 0 0 0 0 0 0 0 0 0 0 0 0 0 0 0 0 0 0 0 0 0 0 0 0 0 0 0 0 0 22 0 0 1 21 
22 22 0 0 0 0 0 0 0 0 0 0 0 0 0 0 0 0 0 0 0 0 0 0 0 0 0 0 0 0 0 0 0 0 0 0 0 0 0 0 0 0 0 0 0 0 0 0 0 0 0 0 0 0 0 22 0 0 0 22 
22 26 21 21 21 21 21 21 21 21 21 21 21 21 21 21 21 21 21 21 21 21 21 21 21 21 21 21 21 21 21 21 21 21 21 21 21 21 21 21 21 21 21 21 21 21 21 21 21 21 21 21 21 21 21 27 0 0 0 22 
0 0 0 0 0 0 0 0 0 0 0 0 0 0 0 0 0 0 0 0 0 0 0 0 0 0 0 0 0 0 0 0 22 0 0 0 0 22 0 0 0 0 0 0 0 0 0 0 0 0 0 0 0 0 0 0 0 0 0 22 
0 0 0 0 0 0 0 0 0 0 0 0 0 0 0 0 0 0 0 0 0 0 0 0 0 0 0 0 0 0 0 0 22 0 0 0 0 0 0 0 0 1 21 2 0 0 0 0 0 0 0 0 0 0 0 0 0 0 0 22 
21 21 21 21 21 21 21 21 21 21 21 21 21 21 21 21 21 21 21 21 21 21 21 21 21 21 21 21 21 21 2 0 0 0 1 21 2 1 21 21 2 0 0 0 0 0 0 0 1 21 8 21 8 21 2 0 1 21 2 22 
